tango - atarashī tango o mainichi oboeru no wa taisetsudesu .
bunpō - bunpō ga muzukashiku kanjiru toki mo arimasu .
gengo - gengo o manabu no wa tanoshī chōsendesu .
hatsuon - nihongo no hatsuon o renshū shiteimasu .
goi - goi o fuyasu tame ni takusan yondeimasu .
renshū - mainichi sukoshi zutsu renshū suru koto ga daijidesu .
kikitori - kikitori no sukiru o kōjō sasetaidesu .
kaiwa - nipponjin to kaiwa suru no wa kinchō shimasu .
kotoba - kotoba no tsukaikata ni ki o tsuketekudasai .
bun - kono bun o tadashiku rikai dekimashita ka ？
honyaku - honyaku wa kanarazushimo kantande wa arimasen .
hatsuon kigō - hatsuon kigō o oboeru no wa taihendesu .
dōshi - dōshi no katsuyō o oboeru no wa muzukashīdesu .
meishi - kono meishi no tsukaikata o oshietekudasai .
fukushi - fukushi wa bun o kyōchō suru tame ni tsukaimasu .
keiyōshi - atarashī keiyōshi o oboeru no ga tanoshīdesu .
setsuzokushi - setsuzokushi o masashiku tsukau renshū ga hitsuyōdesu .
bunmyaku - bunmyaku o rikai suru to imi ga wakari yasuidesu .
dokkai - dokkai no renshū o tsuzuketeimasu .
kunren gogaku no kunren ni wa jikan ga kakarimasu .
gakushū - gengo gakushū wa mainichi no doryoku ga hitsuyōdesu .
jisho - wakaranai tango wa jisho de shirabemasu .
hikki - hikki no renshū o motto shinakerebanarimasen .
hanashikotoba - hanashikotoba wa kakikotoba to kotonaru koto ga arimasu .
kakikotoba - kakikotoba de no hyōgenryoku mo daijidesu .
shidō - sensei no shidō o shikkari to ukemashō .
bunkei - kono bunkei no tsukaikata ga yoku wakarimasen .
rikai - gengo o rikai suru tame ni wa renshū ga hitsuyōdesu .
shūtoku - gengo o shūtoku suru ni wa jikan ga kakarimasu .
hatten go gakuryoku no hatten o mezashite ganbarimasu .
kioku - kiokuryoku o takameru hōhō o sagashiteimasu .
shūchū - gakushū chū wa shūchūryoku ga hitsuyōdesu .
seikaku sa - seikaku sa yori mo ryūchō sa o ishiki shimashō .
ryūchō sa - ryūchō sa o takameru tame ni takusan hanashimasu .
machigai - machigai o osorezu ni hanashimashō .
shitsumon - sensei ni shitsumon suru koto o wasurenaidekudasai .
teisei - kotoba no teisei o sekkyoku teki ni ukeiremasu .
kiroku - gakushū no shinchoku o kiroku suru no ga yakudachimasu .
fukushū - fukushū o okotaranai koto ga jūyōdesu .
tangochō - tangochō o tsukatte goi o fuyashimasu .
ondoku - ondoku wa hatsuon renshū ni kōka tekidesu .
shikaku - shikaku teki ni manabu to kioku ni nokori yasuidesu .
chōkaku - chōkaku o katsuyō shite risuninguryoku o takamemasu .
kurikaeshi - kurikaeshi renshū suru to jōtatsu shimasu .
kakitori - kakitori renshū o mainichi tsuzuketeimasu .
jishobiki - jishobiki o shūkan ni shiteimasu .
jugyō - jugyō de wa itsumo atarashī koto o manabimasu .
reibun - reibun o tsukatte tango o oboe yasuku shimasu .
jugyō - jugyō de wa itsumo atarashī koto o manabimasu .
benkyō - ichi nichi ni sukunakutomo 1 jikan benkyō shiteimasu .
tesuto - tesuto mae ni wa shikkari to fukushū shimashō .